 _____|------|_____ 
|XXXXXXXXXXXXXXXXXX|
|____XXXXXXXXXX____|
    /XXXXXXXXXX\    
    ====|)(|====    
 ___\XXXXXXXXXX/___ 
|XXX(----------)XXX|
|XXX(----------)XXX|
|___(----------)___|
    /XXXXXXXXXX\    
    ====|)(|====    
 ___\XXXXXXXXXX/___ 
|XXXXXXXXXXXXXXXXXX|
|XXXXXXXXXXXXXXXXXX|
 -----|______|----- 