 bbbbbbbbbbbbbbbbbb 
bVVVVVVVVVVVVVVVVVVb
bBBBBVVVVVVVVVVBBBBb
    bVVVVVVVVVVb    
    BBBBBBBBBBBB    
 bbbbVVVVVVVVVVbbbb 
bVVVBBBBBBBBBBBBVVVb
bVVVBBBBBBBBBBBBVVVb
bBBBBBBBBBBBBBBBBBBb
    bVVVVVVVVVVb    
    BBBBBBBBBBBB    
 bbbbVVVVVVVVVVbbbb 
bVVVVVVVVVVVVVVVVVVb
bVVVVVVVVVVVVVVVVVVb
 bbbbbBBBBBBBBbbbbb 