 bRRbbbbbbbbbbbbRRb 
RVVVVVVVVVVVVVVVVVVR
RBBBBVVVVVVVVVVBBBBR
    bVVVVVVVVVVb    
    BBBBBBBBBBBB    
 bbbbVVVVVVVVVVbbbb 
RVVVBBBBBBBBBBBBVVVR
RVVVBBBBBBBBBBBBVVVR
RBBBBBBBBBBBBBBBBBBR
    bVVVVVVVVVVb    
    BBBBBBBBBBBB    
 bbbbVVVVVVVVVVbbbb 
RVVVVVVVVVVVVVVVVVVR
RVVVVVVVVVVVVVVVVVVR
 bRRbbBBBBBBBBbbRRb 